******* ************* 
* *       *       * * 
* ***** * * * *** * * 
* *   * * * * * * * * 
* * * *** * * * * * * 
* * *   *   * * *   * 
* * *** * *** * *** * 
*   * * * * * *   * * 
***** * * * * *** * * 
*     * *   *   *   * 
* *** * *** *** *** * 
* *   * *     *   * * 
* ***** ********* * * 
*       *       * * * 
* ******* ***** * * * 
*         *   *   * * 
* ********* ******* * 
*       *   *     * * 
* ******* * * *** * * 
*         *     *   * 
********************* 
1
1